NO assets/textures/wall.xpm
SO assets/textures/wall_2.xpm
WE assets/textures/wall_3.xpm
EA assets/textures/wall_4.xpm

F 184,113,39
C 51,198,227

11111111
10000001
10000001
10011001
10010001
1000N001
10000001
11111111
