NO assets/textures/wall.xpm
SO assets/textures/wall_2.xpm
WE assets/textures/wall_3.xpm
EA assets/textures/wall_4.xpm

F 184,113,39
C 51,198,227

111111111111
100000000001
100000N00001
111111111111
