NO assets/textures/wall.xpm
F 51,198,227
SO assets/textures/wall_2.xpm
WE assets/textures/wall_3.xpm
EA assets/textures/wall_4.xpm
C 51,198,227




11111111111111111111111111111
10000000011001100110000000001
10000000011001100110000000001
10000000000000000000000000001
10000000000000000000000000001
10010000010101010101000001001
10010000111111111111100001001
10010000010000000001000001001
1000000001000000000100000001
10010000111100100111100001001
10010000010100100101000001001
1001000000000000NNN0000000001
10000000100100100100100000001
10000000111100100100111111111
10000000000000000000000000101
11111111111111111111111111111
