NO assets/textures/wall.xpm
SO assets/textures/wall_2.xpm
WE assets/textures/wall_3.xpm
EA assets/textures/wall_4.xpm

F 184,113,39
C 51,198,227




11111111111111111111111111111
10000000011001100110000000001
10000000011001100110000000001
10000000000000000000000000001
10000000000000000000000000001
10010000010101010101000001001
10010000111111111111100001001
10010000010000000001000001001
10000000110000000001100000001
10000000010000000001000000001
10010000111100100111100001001
10010000010100100101000001001
10010000000000000000000001001
10000000100100100100100000001
10000000111100100111100N01001
10000000000000000000000000101
11111111111111111111111111111
