NO textures/wall_1.xpm
SO textures/wall_2.xpm
WE textures/wall_3.xpm
EA textures/wall_4.xpm

F 184,113,39





K
C 51,198,227

     1111
   10E01
1000001
1111111
1111
